###############..
#.........#...#..
#.........#...#..
#.........#...#..
#........T....#..
#.........#...#..
#.........#...#..
#.........#...#..
###########...#..
#.............#..
#.............#..
#.............#..
#.S.###########..
#...#............
#...#............
#...#............
#...#............
#...#............
#...#############
#...............#
#.............@.#
#...............#
#################