########################
#...#..........###.....#
#.....#.####.....#.#####
#.##..###....##..###...#
#....@..#.............##
##K...S.#..........#...#
#....U..#........##...##
#..####..........#....##
#.##......##.##.##...###
#.........#..........#.#
#.#.....#....#.....#...#
#.#.....#....#.....#...#
########################