########################
#...###........###.....#
#.....#.####.....#.#####
#.##..###....##..###...#
#....@.....#..........##
##K...S.....#...#..#...#
#....U.....#.#..###...##
#..#..#....#..#..#....##
#.##.##...##.##.##...###
#.........#..........#.#
#.#.....#....#.....#...#
#.#.....#....#.....#...#
########################