########################
#...###........###.....#
#.....#.####.....#.#####
#.##..###....##..###...#
#....@................##
##K...S............#...#
#....U...........##...##
#..#..#..........#....##
#.##......##.##.##...###
#.........#..........#.#
#.#.....#....#.....#...#
#.#.....#....#.....#...#
########################