#########################
#..........####.........#
#..........####.........#.
##...###...####....#....#
#.....#....####....#....#
#.....#....####....#....#
#.....#....#####..##....#
#.....#............#....#
#..@..#............#....#
#########################
