######################
#.......####......U..#
#.......####.........#.
#.......####....###..#
#.......####....#....#
#.......####....#....#
#.......#####..##.@..#
#...............#....#
#...............#....#
######################
