########################
#..............#.......#
#......S...............#
#...@...#......#.......#
#.....K.####..###......#
#..U....#.......#......#
#.......#.......#......#
####..###...#...#......#
#.......#.......#......#
#.......#.......#......#
#...............#......#
#......................#
########################