####################
#@.#...............#
#..#....#######....#.
#..#....#.....#....#
#..#..###.....#....#
#..#....#..........#
#.K#....#.##########
#.......#..........#
#.......#..........#
####################
