##########################
#..........#.......#.....#
#..........#.............#.
#..........#..........#..#
#...#...########...#..#..#
#...#......#.......#..#..#
#..U#......#.......#..#..#
#...#......#...#...#..#..#
#...#..........#...#..#..#
#...#..............#.....#
#.@.#......#.......#.....#
##########################