############################
#....#.....................#
#....#.....................#
#....#...............###...#
#....#...#######.....#.....#
#....#.........#.....#.....#
#....#......@..#.....#.....#
#..............#.....#####.#
#....##############..#.....#
#....#...............#.....#
#....................#.....#
#....#...............#.....#
############################
