#####################
#...................#
#...................#
#......#............#
####...#...######...#
#..#...#...#....#...#
#..#####...#....#...#
#...............#...#
#...............#...#
#@.#...#...#....#...#
####...#...#....#...#
#......#...######...#
#......#............#
#......#............#
#......#............#
#####################
