########################
#...............##.....#
#...............##.....#
#...............##.....#
##########..##..##..#..#
#...........##......#..#
#...........##......#..#
#...#.......#########..#
#...#.......#####...#..#
#...#.......#####......#
#...#####...#####......#
#.......#...#####...#..#
#.......#...........#..#
######..#...........#..#
#....#..####..#######..#
#....#..#...........#..#
#....#..............#..#
#.........#U..#........#
#.........#.@.#........#
########################
